11111111111111111111111111111111111111
1P000E10000001C10011C111111111CCC11111
1110101000000100001101C000000001111111
1C000000C00001111011011111101111111111
11111110000001000011011111101111111111
10000C00000001000000011111001111111111
1111111C111111000011111110001111111111
100000000C000000001C1110001111111111C1
100000000000C1000000000000000CCCCCCCC1
11111111111111111111111111111111111111