1111111
1P000E1
1111101
1C00001
1111111