11111
1P0E1
11101
1C001
11111
