1111111111111
1001000110CC1
1000011111011
1P0011E000C01
1111111111111