1111111111111
10P0000000001
1011110111101
1C0010000C001
1001011110101
10000000000E1
1111111111111