1111111111111
1P10000000001
1110111111101
1C00100000001
1111111011111
1000000000E01
1111111111111