1111111111111
1P00000000011
1011110111101
1C0010000C001
1011011110101
10000000000E1
11111111111111
